111111111111111111111111
100000000000000000000001
100111111111111111111011
100100000000000000000001
100100222220222323232201
100100200000400000000001
100000200020444304434401
111100200020400000000001
100120220220400303030001
100003000000400000000001
100003000034000000000001
100003330030000000000001
100000000333000000000001
100000000000000000000001
100000000000000000000001
100000000000000000000001
144444444000000000000001
140400004000000000000001
140000504000000000000001
140400004000000000000001
140444444000000000000001
140000000000000000000001
144444444000000000000001
111111111111111111111111
